xxxxxxxxxxxxxxxxxxxxxxxxxxxxxxxxxxxxxx
xx                                  xx
xx                                  xx
xx                                  xx
xxxxxxxxxxxxxxxxxxxx  xxxxxxxxxxxxxxxx
xx                                  xx
xx                                  xx
xx                                  xx
xx     vvvvvvvvvvvvvvvvvvvvvvvvvvvvvxx
xx     uuuuuuuuuuuuuuuuuuuuuuuuuuuuuxx
xx     uuuuuuuuuuuuuuuuuuuuuuuuuuuuuxx
xx     uuuuuuuuuuuuuuuuuuuuuuuuuuuuuxx
xx                                  xx
xx         ff                       xx
xx     xxxxxxxxxxxxxx               xx
xx                                  xx
xx                                  xx
xx                                  xx
xx                                  xx
xx                                  xx
xx                                  xx
xx                                  xx
xx                                  xx
xx                                  xx
xx                        fff       xx
vvvvvvvvvvvvvvvvvvvvvvvvvvvvvvvvvvvvvv
