xxxxxxxxxxxxxxxxxxxxxxxxxxxxxxxxxxxxxx
xx                   dd        dd   xx
xx                                 lxx
xx                        ff      luxx
xx         ff   vvvvvvvvvvvvvvvvvvvvxx
xx         ty                       xx
xx  fff                             xx
xxvvvvvvvvvvvvvvva   svvvvvvvvvvvvvvxx
xx              ua   su             xx
xx              ua   su             xx
xx              ua   su             xx
xx              ua   su             xx
xx              ua   su             xx
xx              ua   su             xx
xx                                  xx
xx                                  xx
xx                                  xx
xxvf          fvvvvvvvvvvvvvvvvvvvvvxx
xxuvf        fvuuuuuuuuuuuuuuuuuuuuuxx
xxuuvf      fvuuuuuuuuuuuuuuuuuuuuuuxx
xxuuuvf    fvuuuuuuuuuuuuuuuuuuuuuuuxx
xxuuuuv    vuuuuuuuuuuuuuuuuuuuuuuuuxx
xxuuuuu   vuuuuuuuuuuuuuuuuuuuuuuuuuxx                   
xxuuuuu   uuuuuuuuu      uuuuuuuuuuuxx
xx m                                xx
xxvvvvvvvvvvvvvvvvvvvvvvvvvvvvvvvv  xx
xx                                  xx
xx                                  xx
xx                                  xx
xx                                  xx
xx                                  xx
xx                                  xx
vvvvvvvvvvvvvvvvvvvvvvvvvvvvvvvvvvvvvv
