xxxxxxxxxxxxxxxxxxxxxxxxxxxxxxxxxxxxxx
xx                   dd             xx
xx                                  xx
xx                       ff         xx
xx         ff   vvvvvvvvvvvvvvvvvvvvxx
xx         ty                       xx
xx  fff                             xx
xxvvvvvvvvvvvvvvv     vvvvvvvvvvvvvvxx
xx              xa   sx             xx
xx              xa   sx             xx
xx              xa   sx             xx
xx              xa   sx             xx
xx              xa   sx             xx
xx              xa   sx             xx
xx                                  xx
xx                                  xx
xx                                  xx
xxvf          fvvvvvvvvvvvvvvvvvvvvvxx
xxuvf        fvuuuuuuuuuuuuuuuuuuuuuxx
xxuuvf      fvuuuuuuuuuuuuuuuuuuuuuuxx
xxuuuvf    fvuuuuuuuuuuuuuuuuuuuuuuuxx
xxuuuuv    vuuuuuuuuuuuuuuuuuuuuuuuuxx
xxuuuuuv  vuuuuuuuuuuuuuuuuuuuuuuuuuxx                   
xxuuuuu   uuuuuuuuu      uuuuuuuuuuuxx
xx m                                xx
xxvvvvvvvvvvvvvvvvvvvvvvvvvvvvvvvv  xx
xx                                  xx
xx                                  xx
xx                                  xx
xx                                  xx
xx                                  xx
xx                                  xx
vvvvvvvvvvvvvvvvvvvvvvvvvvvvvvvvvvvvvv
